6 6 6 6 2 2 2 2 6 6
6 6 6 6 2 0 0 2 6 6
6 6 6 6 2 0 0 2 6 6
6 2 2 2 2 0 0 2 6 6
6 2 0 0 2 0 2 2 6 6
6 2 1 0 0 3 0 2 6 6
6 2 2 2 0 0 3 2 2 6
6 6 6 2 2 4 0 4 2 6
6 6 6 6 2 2 2 2 2 6
6 6 6 6 6 6 6 6 6 6