6222226666
6200022222
6203020002
6200023202
6222300002
6620002222
6620144426
6622222226
6666666666
6666666666